********** *****************
**   G*      
** **** **** *
*  **** **** *
** **** ***   
*  ****S**** *
** *** ***** *
*            ****************
****** *** *********
***************************
