************************
*                      *
******** ***** * ***** *
**    G*   *** * *   * *
** ******* *** * * * * *
** *****     * * * *** *
** ** ****S*** * *     *
** ** *** ** *** *******
**                     *
************************
