************
*          *
* S        *
*          *
*          *
*          *
*    G     *
*          *
*          *
*          *
*          *
************
