********* ******************
**   G*      
** **** **** 
** **   **** 
** **** **** *
** ****S**** 
** ********* *
**           ****************
********************
***************************
