***************************************
*S                                    *
******************************** ******
                               * *
                               * *********************************
                               *                                G*
******************************************************************
